16 9
#_
~
................
................
................
......._........
................
........._......
......._........
.h.....t...~~...
________________