156 26
#_/-
~+n
-..........................................................................................................................................................-
-..........................................................................................................................................................-
-..........................................................................................................................................................-
-..........................................................................................................................................................-
-..........................................................................................................................................................-
-..........................................................................................................................................................-
-..........................................................................................................................................................-
-..........................................................................................................................................................-
-..........................................................................................................................................................-
-..........................................................................................................................................................-
-..........................................................................................................................................................-
-..........................................................................................................................................................-
-..........................................................................................................................................................-
-..........................................................................................................................................................-
-..........................................................................................................................................................-
-...a................................................................................................................................a.....................-
-.........................................................a................................-..............-................................................-
-.h........................................................................................-..........r...-.....-..........................................-
-...............t........................n............nnnnnnn..............................-~~~~~~~~~~~~~~-.....--.........................................-
-..........----------....................n................................................--++++++++++++++-...n.---.....................................***-
-.....r....-.............................n...............................................---++++++++++++++-.....----....................................***-
-~~~~~~~~~~-..a.......................................-.-.-.-...........................----++++++++++++++-...n.-----.............t.....................***-
-++++++++++-.............................t..................--.........................-----++++++++++++++-.....---------------..__________________________-
-++++++++++-..................t.........---.....nnn.........---.......................------++++++++++++++-...n............................................-
-++++++++++-.................--..............t..............----.........t.......t...-------++++++++++++++-....t...............t...........................-
____________________........................._______........______________________..-----------------------...____.__.__.__.__.__..........................-
